空空空空空空空空空空空空敌
空砖空砖空砖空砖空砖空砖空
空砖空砖空砖空砖空砖空砖空
空铁空铁空铁空铁空铁空铁空
敌砖空砖空砖空砖空砖空砖空
空空空空空敌空空空敌空空铁
铁空水水水水空水水水水空铁
空草草草草草草草草草草草空
敌空空空空砖空砖空空空空敌
空砖空砖空砖空砖空砖空砖空